02mssduswn5.www5.sge.su	malware-caphawinfra
0539vqznm.www5.sge.su	malware-caphawinfra
0fmnsn1zwz597p4z3.sge.su	malware-caphawinfra
171cedararts.com	legit-networksolutions
19932rwu0jp1jml.www5.rgk.cc	malware-caphawinfra
1bu861b.www5.sge.su	malware-caphawinfra
1ef2yryj5cu0ds4dw.pare.cc	malware-caphawinfra
1stnewrichmond.com	legit-networksolutions
284fkxo.flyhigh-inc.net	malware-caphawinfra
290sj0fmmvfruar.express-shippingus.biz	malware-caphawinfra
2bjzezp.express-shippingus.biz	malware-caphawinfra
4jv3qsqnpzrnbii.flyhigh-inc.net	malware-caphawinfra
ac-shippingllc.com	malware-caphawinfra
ac-shippingllc.org	malware-caphawinfra
acasgtnbog.doctoreafj.ru	malware-spamviagra
acosutlltn.xigmedic.ru	malware-spamviagra
activeweave.com	legit-networksolutions
adamsandcompany.com	legit-networksolutions
agoristmetals.com	legit-networksolutions
ajo.cc	malware-caphawinfra
alpine-roofing.com	legit-networksolutions
andi.patiroi.medichosg.ru	malware-spamviagra
android.skyrockit.com	legit-networksolutions
bosuntyp.net	legit-networksolutions
boxconsolidators.com	legit-networksolutions
bqywfyhm.sge.su	malware-caphawinfra
carehekjpy.doctoreafj.ru	malware-spamviagra
cbouvyslss.doctorwsxi.ru	malware-spamviagra
ccwxtxkukd.xigmedic.ru	malware-spamviagra
clk0806120.stzwnrbjtc.ru	malware-caphawinfra
clk0906123.ixsadoxnxv.ru	malware-caphawinfra
clk2337022.stzwnrbjtc.ru	malware-caphawinfra
clk2337169.ixsadoxnxv.ru	malware-caphawinfra
cu0806100.eqszchnhkb.ru	malware-caphawinfra
cvovtxdmvu.doctoraqv.ru	malware-spamviagra
doctoralq.ru	malware-spamviagra
doctoraqv.ru	malware-spamviagra
doctorcrddr.com	malware-spamviagra
doctoreafj.ru	malware-spamviagra
doctorznz.ru	malware-spamviagra
dorkvud.sge.su	malware-caphawinfra
edal.cc	malware-caphawinfra
elg.cc	malware-caphawinfra
ephy2atl9aytoqsy.sge.su	malware-caphawinfra
fileimage.com	legit-networksolutions
gamutnyc.com	legit-networksolutions
gdm.cc	malware-caphawinfra
iqmail.net	legit-mail
mail.hotcareerprospects.com	legit-mail
mail.maldunn.com	legit-mail
noaarx.sge.su	malware-caphawinfra
ns1.lanegovonline.net	legit-dns
ns1.serverybsx.com	legit-dns
ns1626.ztomy.com	legit-dns
posse-rweyene.pw	legit-namecheap
prajalx.sge.su	malware-caphawinfra
qhrmqrh.com	legit-networksolutions
smtp.cutlergmac.com	legit-mail
swedent-sentione.pw	legit-namecheap
t1402214666.yupiromo.ru	malware-caphawinfra
tcprajalx.sge.su	malware-caphawinfra
trioservice.info	legit-networksolutions
wretji.sge.su	malware-caphawinfra
www.strm.pw	legit-namecheap
www5.fu180.com	malware-caphawinfra
ytoqsy.sge.su	malware-caphawinfra
